15
15
###############
#I  #    ######
## # #### #####
### ## ### ####
###   ##### ###
#   ## ##### ##
### ## #### ###
#### ##### ####
### ###### ####
## ####### ####
###       #####
##### #########
#### ##########
#S   ##########
###############